0000000000000000000-
0000000000000000000-
0000000000000000000-
1110111011110000000-
0010101010010000000-
0010101010010000000-
0010101010010000000-
0010101010010000000-
0010101010010000100-
0011101110011111100-
0000000000000000000-
0000000000000000000-
0000000000000000000-
0000000000000000000-
0000000000000000000-