00000000000000000000000000000000000000-
00000000000000000000000000000000000000-
00000000000000000000000000000000000000-
11101110111100000000000000000000000000-
00101010100100000000000000000000000000-
00101010100100000000000000000000000000-
00101010100100000000000000000000000000-
00101010100100000000000000000000000000-
00101010100100001000000000000000000000-
00111011100111111000000000000000000000-
00000000000000000000000000000000000000-
00000000000000000000000000000000000000-
00000000000000000000000000000000000000-
00000000000000000000000000000000000000-
00000000000000000000000000000000000000-