0000000000000000000000-
0000000000000000000000-
0000000000000000000000-
1110111011110000000000-
0010101010010000000000-
0010101010010000000000-
0010101010010000000000-
0010101010010000000000-
0010101010010000100000-
0011101110011111100000-
0000000000000000000000-
0000000000000000000000-
0000000000000000000000-
0000000000000000000000-
0000000000000000000000-